"filename", "language", "Python", "comment", "blank", "total"
"d:\Python\GUI\AbilitiesPanel.py", "Python", 74, 0, 17, 91
"d:\Python\GUI\CastleScreen.py", "Python", 24, 0, 5, 29
"d:\Python\GUI\CombatScreen.py", "Python", 183, 0, 47, 230
"d:\Python\GUI\Frame.py", "Python", -1, 0, 0, -1
"d:\Python\GUI\GraphicComponents.py", "Python", 30, 0, 10, 40
"d:\Python\GUI\HeroWidget.py", "Python", 1, 0, 0, 1
"d:\Python\GUI\PlayerPanel.py", "Python", 50, 0, 15, 65
"d:\Python\GUI\Tile.py", "Python", 2, 0, 0, 2
"d:\Python\GUI\_const_combat_modifiers.py", "Python", 4, 0, 0, 4
"d:\Python\Game.py", "Python", 10, 0, 5, 15
"d:\Python\GameLogic\Ability.py", "Python", 125, 0, 22, 147
"d:\Python\GameLogic\Combatiant.py", "Python", 9, 0, 3, 12
"d:\Python\GameLogic\DiceRoller.py", "Python", 1, 0, 0, 1
"d:\Python\GameLogic\Hero.py", "Python", 46, 0, 17, 63
"d:\Python\GameLogic\Inventory.py", "Python", 25, 0, 1, 26
"d:\Python\GameLogic\Items.py", "Python", 15, 0, 6, 21
"d:\Python\GameLogic\Minion.py", "Python", 4, 0, 1, 5
"d:\Python\GameLogic\Placeable.py", "Python", 2, 0, 1, 3
"d:\Python\Testing\Tests.py", "Python", -16, -3, -2, -21
"Total", "-", 588, -3, 148, 733